111111111111111111111
1E0010C00000000000001
100011100000000000001
1P0000100000000000001
100000100000000000001
100C00100000000000001
100001100000000000001
100001C00000000000001
1E0001000000000000001
100001000000000000001
100001000000000000001
100001000000000000001
100001000000000000001
100001111110000000001
100000000010000000001
100000000010000000001
100000000010000000001
100000000010000000001
100000000010000000001
100000000000000000001
100000000000000000001
100000000000000000001
100000000000000000001
111111111111111111111